

       a  b  c  d  e  f  g  h
       0  1  2  3  4  5  6  7
       _  _  _  _  _  _  _  _

7  8 | _  _  _  _  _  _  _  _ | 7 8

6  7 | _  _  _  _  _  _  _  _ | 6 7

5  6 | _  _  _  _  _  _  _  _ | 5 6
                c 
4  5 | _  _  _  _  _  _  _  _ | 4 5

3  4 | _  _  _  _  _  _  _  _ | 3 4

2  3 | _  _  _  _  _  _  _  _ | 2 3

1  2 | _  _  _  _  _  _  _  _ | 1 2

0  1 | _  _  _  _  _  _  _  _ | 0 1

	   0  1  2  3  4  5  6  7
	   a  b  c  d  e  f  g  h